R	1920	1080

S	../../sprites/pillar.xpm

NO	../../sprites/eagle.xpm
SO	../../sprites/colorstone.xpm
WE	../../sprites/greystone.xpm
EA	../../sprites/purplestone.xpm

F	101,102,103
C	201,202,203

1111111111111111111111111
1000000200011220000000011
1001100000011220000110011
1000000000011000000000011
1111111100011000111111111
1200000100011000100000011
1111100100111100100111111
1000000000011000000000011
1100110000011000001100111
10002100000000N0001000011
1000210000002000001000011
1000210110000001101000011
1000210210000011001222211
1111111111100111111111111
1000000001000010000022211
1000200000000000000000211
1000000001000010000022211
1111111111100111111111111
1220000000100100000002211
1000011111111111111111111
1220011100100100100002211
1111111111101111111111111
