R	1920	1080

S	../../sprites/pillar.xpm

NO	../../sprites/eagle.xpm
SO	../../sprites/colorstone.xpm
WE	../../sprites/greystone.xpm
EA	../../sprites/purplestone.xpm

F	101,102,103
C	201,202,203

111111111111111111111111
100000020001122000000001
100110000001122000011001
100000000001100000000001
111111110001100011111111
120000010001100010000001
111110010011110010011111
100000000001100000000001
110011000001100000110011
1000210000000N0000100001
100021000000200000100001
100021011000000110100001
100021021000000100122221
111111111110011111111111
100000000100001000002221
100020000000000000000021
100000000100001000002221
111111111110011111111111
122000000010010000000221
100001111111111111111111
122001110010010000000221
111111111111111111111111
